4 12 12
113111111111
122222222221
121121111121
121221222121
121212212121
121612112111
121112212121
121211212121
122222212221
111111111121
122222222221
114111111111
