2 51 51
131111111111111111111111111111111111111111111111111
121622122222221222222222222222122212122212222222121
121112121212111211111111121112121212121212121112121
122212221212122212222212221222221222121222122212221
111211111212121111111212111112111111121111111211111
122212222212121222222212222212122222221222121212221
121112111111121212111211111212121111111212121212121
121222222222221212122222221212122212222212221222121
121111121111111112111111111211111212111112111111121
121222122222222212122212221212222212122222122222221
121212111111111212121212121212111112111111121111121
122212221222221212121222121212122222122212221222121
111111121211121212121111121212121211121212111212121
122222122212221212121222121222121222121222121212121
121112111112111212121212121111121112121111121212121
121212222212122212222212122222122212122212221212121
121211121112121111111111121112111212111212121212121
121212221222121222222222121212221212221212121212221
121212111211121212111112121211121212121212121211111
122212221212221212122212221222121212121212121222121
111211121212111112121211111211121212111212121112121
122212221212122212121222122212221212122212122212221
121112111212121212111212121212111112121112121111121
121212222212221222122212121212122212121222121222121
121211111111111111121111121212121212121212111212121
121222122222221222222222221212221212121212222212221
121212111112121112111111111211111212121112111112111
121212122212122212221222122222121222122212122212121
121212121212111211121212121112121112111211121212121
122212121212221222122212122212122212121222221212221
111112121212121112111111111212121112121111111211121
122222121212122212221222221212221222122222221212121
121111121211121211121211121211111211121112111212121
121222221222121222122212121222122212222212221212121
121112111112121112111112121112121111111211121212121
121222122212122212221222122212222222221222121212221
121211121212111111121212111211111111121211121212111
121212221212122212221212222222122212121212221212221
121211111212121212111111111112121212121212111211121
121222221212221212222222222212121212221212122212221
121211121211111212111111121212121211121112121112111
121212221222122212221222121212121222121222121222121
121112111112121111121212121212121112121212121112121
121222122222121222121212121212221222122212122212121
121211121212121112121212121212111112121111111212121
121212121212122212221212121212122212121222222212221
121212121211111211111212111211121212111211111111121
121212121212221212222212221222221212222212221222221
121212121212121212111111121111111211111112121211111
122212221222122222122222222222222212222222122222221
111111111111111111111111111111111411111111111111111