1 1 3 1 1 1 1 1 1 1 1 1
1 5 5 5 5 2 2 2 2 2 2 1
1 5 1 1 5 1 1 1 1 1 2 1
1 5 1 5 5 1 5 5 5 1 2 1
1 5 1 5 1 5 5 1 5 1 2 1
1 5 1 5 1 5 1 1 5 1 1 1
1 5 1 1 1 5 5 1 5 1 2 1
1 5 1 2 1 1 5 1 5 1 2 1
1 5 5 5 5 5 5 1 5 5 5 1
1 1 1 1 1 1 1 1 1 1 5 1
1 2 5 5 5 5 5 5 5 5 5 1
1 1 4 1 1 1 1 1 1 1 1 1
---
length=55
time=59