1 101 101
13111111111111111111111111111111111111111111111111111111111111111111111111111111111111111111111111111
12122222222212221222221222221222221222221222221222122222221222122222122212222222221222221222222222121
12111212111212121112121212121211121211121212121112121211121211121212121212111112121211111211111212121
12221212221222122212121212122212221222121212122212221212221222121212121212221212122212222212222212121
11121211121111111211121212111112111112111212111211111212111112121212121111121212111212111112111112121
12121222121222122212221212221212221222122212221222122212122212221212122212221212221212122222122212121
12121111121212111212121211121211121211121111121112121112121211111212111212111211121112121111121112121
12122222122212221212121212221212221222222212221212221222121212221212221222222222122222121212222212221
12111112121111121212111212111212111111111212111211111211121212121211121111111112111111121212111211121
12221222122212121212222212221222122222221212221222221212221212121222122222122212122212221222122212121
12121211111212121212111111121211121111121111121112121211121212121112111112121212111212111211121212121
12122212222222121212222212121212221222122222122212121222121222122212122212121212221212122212221212121
12111111111111121211111212121212121212111112121212111112121111111212121112121211121212111112111212121
12122222122222121212222222121212121212221222121212122222121222121212122222121222222212122212221212121
12111212121112121211111112121211121212111211111212121111121212121212121111121111111112121212121212121
12221212221222121222222212121212221212222212222212121222221212121212121222121222122212121212121212121
11121211111211121111111211121212111211111111121112121211111212121212121212121212121212121211121212121
12221212221222122222221222121222121212122222122212222212222212121212121212122212121212121212221212121
12111212111112121111121112121111121212121212111211111111121212121212121212111111121212121212111212121
12221212222212122222122212221222121212221212221222122222121212221212121212222222221212221212121212121
11121211111212111112111211111212121211111211121112121112121211121212121211111111111211121212121212121
12121212221222122212121222122212221222221222122212122212121222121222121212222212221222121212122222121
12121212121211111212121112111212111111121212111212121212111112121111121212111212121112111212111112121
12121222121222221222122212221212122222121212122222121212222222122222121212221222121222122212221222121
12121111121111121211121111121211121112121212121111121211111211111112121212121211111211121112121211121
12122212221222121212122222121212221222121212121222121212222212222212121212121212222212221212121212221
12111212111212121212121112121212111211121212111212121211121112111211121212121112111111121212121212111
12221222121212121212221222121212122212221212222212121222121222121212221212122222122222221222121212121
12111111121212121211111211121212121212111211111112111112121211121212111212111111111211111211121112121
12222212221212221212222212221212121212221212222212122212121222121222122212122222222212221222121222121
12121212121211111212111212111212121211121212111212121212111112121111121112111111121112121112121211121
12121212121222221212121212221222121212121212122212221212222222122222121212222222121222121222121222221
12121212121111121212121211121211121212121112121111111211111211121112121211111112121212121211121111121
12121222122212221222122222121212221212122222121222221222221212222212121222221212121212121222122222121
12121111121112111112111111121112111212111111121211121111121211111212121211121212121112111112111211121
12122212221222122212122212221222122222122212221212221222121212222212221212221212122212122212121222121
12111211111211121211121212111211111112121212111211121212121212111111111211121212111212121212121112121
12121222222212221222221222122212221222221212221222121212221212222212221222122212221212121222121222121
12121111111112111111111111121212121111111211121212121211111212111211121212111211121212121111121211121
12122212222212122212222222121222122222121212121212122212221212121222122212221212221212122212221222121
12121211121212121212111212121111111112121212121112111112121212121112111211121212111212111212121112121
12221212221212221212121212121222221222122222122222122222161212222212221222121212122212221212121212121
11111212111212111212121212111211121211111112111111121111111212111111121111121112121111121212121212121
12221212122212221212221212222212121222221212122212222222122212122222221222221222122222121212121212121
12111212121111121211111211111112121211121212121211121112121111121111111211121211121112121212121212121
12122212121212221222221222122222221212121212121222121222121222121222122212121222122212122222121212121
12121112121212111111121212111211111212121212121112111212121212121212111212121112111212111111121212121
12221222121222122212121212221212221212121222121212221212121212122212122212222212121212222212221212221
12111211121211121212121111121212121212121211121211121212121212111112121111111212121211111211121211111
12222212121222221212122212221212122212121222121222221212121212221222122222221212121212221222121222221
11111112121111111212111212111211121112121112121211111211121211121211121111121112121211121112121211121
12221222121222221212221212122222122222121222121222122212221212221222121222122212122222121222122212221
12121212121211121211121212111112111111121211121112111212111211121212121212111212111112121211111112111
12121212121212121212221212221222122222221222121222222212221222121212122212121212222212221222122222121
12111212121212121212111212121112121112111112121111111211121212121112111112121211111211121112111112121
12222212122212121212221212122212122212122212122212222222121212122222122212221222221212221212122212221
11111112111112121211121212111212111212121212111212111111121112111111121212111212111212111212121211111
12222212221222121222221212221212222212121212221212122212221222122212221212122212122212221212221222221
12111212121211121111121211111211111112121211121212121212111211121212121212121112121111121211111111121
12121212121212221222121222221212222222121222122212121222122222121222121212121212121222121222222212221
12121212121212111112121111121211111111121112111112121111121112121111121211121212121212121112121212111
12121212121212122212222212221222122212221212122212122212122212122222121212221212121212222212121212221
12121212121212121211111112111212121212111212121211111212121112111111121212111212121211111211121211121
12122212121212221222221222122212121222122212221222221212121222122222221222122212121212221222121212121
12121112121211111111121211111212121111121111111111121212121211121111111111121112121212121112121212121
12122222122212221222221212221212122212222222122222121212121212221222122212221222121212122212221222121
12111111111212111211111212121212111212111212121112121212121212121212111212121211121112111211111111121
12221222221222122212222222121212222212122212122212122212221212121212221212122212221222121222122222121
12121112121112121111111111121211111112121112111212111112111212111211121212111112111211121112121112121
12122212122212121222222222121212221222121222122212221212122212122212121222122222122212122222121222121
12111212111112121212111112121212121211121211121111121212121112121112121112121111121112121111121211121
12221212222222121212122222121212121222121212221212221222122212121222122212121222221222121222221212221
11121211111112121112121111121212121211121212111212111112111212121212111211121211111212121212111212121
12221222222212122222122212221222121212221222122212222212122212221212221212221212222212121212121222121
12111111111212111111111212111111121212111111121211111211121112111212121212111212111112121112121111121
12122212221212221222221212122212221212122222121222222212221212121212121222122212122222122212122222121
12121211121211121211121212121212111112121212121111111112111212121212121111121212121112111212121212121
12121212221222121222121212221212221222121212121222122222122212122212122222121212121222122212121212121
12121212111112121112121211111211121211111212121212111211121212111212111112111212121211121112121212121
12221212221222121222121222221212122212221212121212222212221212221212121222122212121212121222121212121
11111212121211121212111111121212111112121211121211111112111211121112121211121112121212121212111212121
12222212121222122212122222122212222222122212221212221222122222122222122212222212121222121212221212121
12111112121112111112121211111112111111121112111212121211121111111111121111111212121211121211121212121
12221212122212222212121222122222122222121222122212121212221222222212221222122212121212221222121212121
11121212111211111212121112121112121212121211111212121112111212111112111212121112121112111112121211121
12121222221212222212121212221212121212121222221212122222122212122212122212221212122222122212121212221
12121111111212111112121211111212121211121111121212111112121112121212121211111212111111121211121212111
12122222221212122222122212222212121222221212221212222212121212121222121222122212122212221222221212121
12111111121212111112111211111212121111111212111211111212121212121111121112121212121211121111111212121
12221222121212122212221222122212122212222212122212221212122212122212121212121212221222121222221222121
12121212121212121211111112121112111211121112111212121211121112111212121212111211111112121211121112121
12122212121212121212222222121222122222221222122212121222121222122212121212122212222212121212122212221
11111112121212121212111111121211111112111211121112121112121211121112121212121212121212121212111211121
12222222122212221212122222221222221222122212221222122212121222221222222212121212121212121212221222121
12111112111211111212111111121111121111121112121211111212121111111111111212121112121112121212121112121
12221212121212221212221222222212121222221222121212221212222212221222122212121222121222122222122212121
11121212121212121211121211111212121211111211121212121211111212121212111112121211121211121111111112121
12221222221212121222121212221222122212221222122212121222121212121212122212121212122212222212222212121
12111111111212121112121212121112111112121111111112121112121212121212121212121212111111111112111212121
12222222222222122212222212122222222222122222222222122222122222122212221222122222222222222222122222121
11111111111111111111111111111111111111111111111111111111111111111111111111111111111111111111111111141