3 21 21
134111111111111111111
122222222222222212221
111111111111111211121
122222122222221222121
121211121112111112121
121212221212222222121
121112111211111111121
122222122222221222221
121111111211121111121
122212221212221222221
111212121212111211121
121222121212122212121
121111121212121112121
122222122212121222121
121112111112121211121
122212222212121222121
111212111112121212121
122212122222121212221
121112121111121211111
122212222222221222261
111111111111111111111